***************
*111*222222222*
*111*22222222**
*111*2222222*3*
*111*222****33*
*1111*2*333333*
*11111*3333333*
*11111*3333333*
*11111*****333*
*1111*44444*33*
*****4444444*3*
*444444444444**
*4444444444444*
***************
